{"bricks":[
[0,0,0,0,0,0,0,0,0,0,0,0,0],
[0,0,0,0,0,0,0,0,0,0,0,0,0],
[6,0,0,0,0,0,0,0,0,0,0,0,0],
[6,5,0,0,0,0,0,0,0,0,0,0,0],
[6,5,4,0,0,0,0,0,0,0,0,0,0],
[6,5,4,3,0,0,0,0,0,0,0,0,0],
[6,5,4,3,1,0,0,0,0,0,0,0,0],
[6,5,4,3,1,7,0,0,0,0,0,0,0],
[6,5,4,3,1,7,8,0,0,0,0,0,0],
[6,5,4,3,1,7,8,2,0,0,0,0,0],
[6,5,4,3,1,7,8,2,6,0,0,0,0],
[6,5,4,3,1,7,8,2,6,5,0,0,0],
[6,5,4,3,1,7,8,2,6,5,4,0,0],
[6,5,4,3,1,7,8,2,6,5,4,3,0],
[9,9,9,9,9,9,9,9,9,9,9,9,1],
[0,0,0,0,0,0,0,0,0,0,0,0,0],
[0,0,0,0,0,0,0,0,0,0,0,0,0],
[0,0,0,0,0,0,0,0,0,0,0,0,0]]}