{"bricks":[
[0,0,0,0,0,0,0,0,0,0,0,0,0],
[0,0,0,0,0,0,0,0,0,0,0,0,0],
[0,0,0,0,0,0,0,0,0,0,0,0,0],
[0,0,0,0,0,0,0,0,0,0,0,0,0],
[9,9,9,9,9,9,9,9,9,9,9,9,9],
[1,1,1,1,1,1,1,1,1,1,1,1,1],
[2,2,2,2,2,2,2,2,2,2,2,2,2],
[7,7,7,7,7,7,7,7,7,7,7,7,7],
[8,8,8,8,8,8,8,8,8,8,8,8,8],
[3,3,3,3,3,3,3,3,3,3,3,3,3],
[0,0,0,0,0,0,0,0,0,0,0,0,0],
[0,0,0,0,0,0,0,0,0,0,0,0,0],
[0,0,0,0,0,0,0,0,0,0,0,0,0],
[0,0,0,0,0,0,0,0,0,0,0,0,0],
[0,0,0,0,0,0,0,0,0,0,0,0,0],
[0,0,0,0,0,0,0,0,0,0,0,0,0],
[0,0,0,0,0,0,0,0,0,0,0,0,0],
[0,0,0,0,0,0,0,0,0,0,0,0,0]]
, "enemies": [
{
	"spawnDirection": "0",
	"blockCount": 15
},
{
	"spawnDirection": "0",
	"blockCount": 25
}]}